#########################
#@......................#
#.......................#
#.......................#
#.......................#
#.......................#
#.......................#
#########################