11111111111111111111211111111111111111
10000000000000000000000000000000111111
10000100000111100001111000001111111111
10000000011111111000000111111100000001
10111110000111111111111111111000000001
10000001111111100000001100000001000001
10000001111110000011111000001001000101
10001111110001000000100010011111111111
10000000000000000200000000000000000001
10000000000000000000000000000000000001
10000000000000000000000000000000000001
11111111111111111111111111111111111111