#########################
#......................@#
#..#..#....##...##..#..!#
#......#.....#..........#
#.......................#
#.......................#
#.......................#
#########################