##########################################
#@.......................................#
#........................................#
#........................................#
#........................................#
#........................................#
#........................................#
#........................................#
#........................................#
#........................................#
##########################################