##########################################
#...........###......#####.....####......#
#......######......########.......#####..#
####...#####......#####.....####.....###.#
#.....####....###....#####......####.....#
#....####.....####...###....####...###...#
#........................................#
#........................................#
#........................................#
#........................................#
##########################################