#########################
#                      H#
#  #  #    ##   ##  #  M#
#      #     #          #
#        ***            #
#                 X     #
#                       #
#########################