#########################
#H                    # #
########## #*  #     * ##
# #       M      *      #
#   # #####   *     M   #
# ###     ###############
######## ################
#####         ###      ##
#X     #####      #######
#########################