#########################
#H#                   # #
# ###                # M#
# #                     #
#   # #####             #
# ###     ####          #
# #                     #
#########################