###############
#H    #       #
### # # # # # #
#   #   # # # #
######### # # #
#      #  # # #
# # ** #### ###
# #           #
# #############
# #   #      ##
# # #   **** X#
#   # #      ##
###############