##############
#H           #
#    M       #
#            #
#        X   #
##############