###############
#   #       # X
# # # #####   #
# ### #   #####
# #   # # #   #
# # ### # ### #
#       #   # #
###########   #
#     #   # ###
# ### # #     #
#   # # # ### #
### # # # # # #
#H  #   # #   #
###############