###################
# #          #    #
#H  #######M    * #
##### #   ####### #
#   #   #         #
### # * ###########
#   #   # #       #
# * # ### # ##### #
#M          #  X# #
######### * # ### #
# #   #   * # #   #
# # *## # * # # * #
#M      #   #     #
###################